111111111111111
102220002200001
101210101010101
100220003040001
101010101010101
103000222000001
101010101012101
100022030200201
121012121010101
122200022002011
101210101010101
100220003000221
101010101212101
120020000005001
111111111111111