1111111111111111111
1000020030000220001
1210101010101010121
1000300200000002221
1010101010121010121
1202000200300000221
1012101010101010101
1003000002220003001
1010151010121010121
1000222000022203001
1010121010101210101
1220003000300222001
1010101010101010101
1000022222222200541
1010121211121210101
1002220003002220001
1012121210101010101
1000220000300000001
1111111111111111111