1111111111111111111111111
1220000300220030020030001
1210101012101010121010101
1220302220000000022020001
1010101010101210101012121
1002220030002222000030021
1010121212101210101010101
1222000300022522030222001
1010101010121210121210101
1000302200000222003002221
1010101210121310101210101
1302020220000000022220301
1010121010121012121010101
1000022222000402220020001
1010101010101010101010101
1002200220000222020022001
1010101010101010101010101
1022220002220220002000001
1010101010121010101010101
1020222000020200020020001
1210101010101010101010101
1022200020032200022020001
1212101010101010101010101
1002000003000000222200001
1111111111111111111111111