1111111111
1010003301
1100000001
1000000001
1002222001
1002522001
1000300001
1000000001
1000000401
1111111111